WE ./assets/purplestone.xpm

F 255,25,255

C 0,255,255

NO ./assets/bluestone.xpm
SO ./assets/graystone.xpm
EA ./assets/redstone.xpm

111111
111111
