NO ./assets/bluestone.xpm
SO ./assets/graystone.xpm
WE ./assets/purplestone.xpm
EA ./assets/redstone.xpm

F 255,255,0
C 0,255,

111111111111111111111111111111
100000000000000000000000000001
100000000000000000000000000001
10000 000000000000000000000001
100000000000000000000000000001
10000000000000N000000000000001
100000000000000000000000000001
100000000000000000000000000001
100000000000000000000000000001
100000000000000000000000000001
111111111111111111111111111111
