NO ./assets/bluestone.xpm
SO ./assets/graystone.xpm
WE ./assets/purplestone.xpm
EA ./assets/redstone.xpm

F 255,255,0
C 0,255,255

0000000000000000000000000000000
0111111111111111111111111111110
0100000000000000000000000000010
0100000000000000000000000000010
0100000000000000000000000000010
0100000000000000000000000000010
010000000000000N000000000000010
0100000000000000000000000000010
0100000000000000000000000000010
0100000000000000000000000000010
0100000000000000000000000000010
0111111111111111111111111111110
0000000000000000000000000000000
