NO ./assets/bluestone.xpm
SO ./assets/graystone.xpm
WE ./assets/purplestone.xpm
EA ./assets/redstone.xpm

F 255,255,0
C 0,255,255

11111111111110111111111111111
10000000000000000000000000001
10000000000000000000000000001
10000 00000000 00000000000001
10000000000000000000000000001
10000000000000N00000000000001
10000000000000000000000000001
10000000000000000000000000001
10000000000000000000000000001
10000000000000000000000000001
11111111111111111111111111111
