WE ./assets/purplestone.xpm

F 255,25,255

C 0,255,255

NO ./assets/bluestone.xpm
SO ./assets/graystone.xpm
EA ./assets/redstone.xpm


        1111111111111111111111111
        1000000000110000000000001
        1011000001110000000000001
        1001000000000000000000001
111111111011000001110000000000001
10000000000C000001110111111111111
11010111111111011100000010001
11010111111111011101010010001
11000000110101011100000010001
1000000000000000CO000000C0001
10000000000000001101010010101
11000001110101011111011110E0111
11110111 1110101 101111010001
11111111 1111111 111111111111
