NO ./assets/bluestone.xpm
SO ./assets/graystone.xpm
WE ./assets/purplestone.xpm
EA ./assets/redstone.xpm

F 80,80,80
C 135,206,235

11111111111111C111111111111111
100000000000000000000000000001
100000000000000000000000000001
10000 000000000010001001111001
100000000000000010001010001001111111111111111111111
10000000000000E010001000010001LLLLLLLLLLLLLLLLLLLL1
10000000000000001111100010000L0000000000000000000Q1
100000000000000000001001000001LLLLLLLLLLLLLLLLLLLL1
100000000000000000001011111101111111111111111111111
100000000000000000001000000001
111111111111111111111111111111
